NO ./path_to_the_north_texture
SO ./path_to_the_south_texture
WE ./path_to_the_west_texture
EA ./path_to_the_east_texture
F 74, 65, 42
C 74, 65, 42

                      11111111111
                      10000000001
                      10000000001
                   11110000E00001111
          11111111110000001110000001
   111111111100000000000001 10111111
  110000000000110000011110111001               1111111  1111
11100011100000100001001100010011           11111000001  1001
1100011 1100001000010001000000011111    11110000000001111101
100000111010000000000000001000000001111110000000000000000001
100000000000000110001000000001100000000000000111000000001111
1110000000101111110111100011111111111111111111111101111111
1111000011101111110111110111                     101
11111011111000000000000001                       101
11111111111111101111111111                       101
11111111111111101                                101
11111111111111001                                101
10000000000000011                                101
1011111111111111                                 101
101                                              101
101                                              101
101111111111111111111111111111                   101
1000000000001100000111101110011                1110111  1111
11100011100000100001001100010011           11111000001  1001
1100011 1100001000010001000000011111    11110000000001111101
100000111010000000000000001000000001111110000000000000000001
100000000000000110001000000001100000000000000111000000001111
1110000000101111110111100011111111111111111111111111111111
1111000011101111110111110111
11111011111000000000000001
11111111111111101111111111
              111
