NO ./textures/eagle.xpm
SO ./textures/eagle.xpm
EA ./textures/eagle.xpm
WE ./textures/eagle.xpm

F 0,10,0
C 0,10,0

111111111
100000001
100000001
100101001
101000101
1000N0001
101000101
100101001
100000001
100000001
111111111
