NO ./textures/eagle.xpm
SO ./textures/eagle.xpm
EA ./textures/eagle.xpm
WE ./textures/eagle.xpm

F 0,10,0
C 0,10,0

D ./textures/portal/
X ./textures/portal/
11111
1X2N1
11111
