NO ./textures/portal.xpm
SO ./textures/eagle.xpm
EA ./textures/eagle.xpm
WE ./textures/eagle.xpm

F 0,10,0
C 0,10,0

1111
1XN1
1111
