NO ./textures/eagle.xpm
SO ./textures/eagle.xpm
EA ./textures/eagle.xpm
WE ./textures/eagle.xpm

F 0,10,0
C 0,10,0

11111
10001
10N01
10001
10001
10001
10001
10001
10001
10001
10001
10001
10001
10001
10001
10001
10001
10001
10001
10001
10001
10001
10001
10001
10001
10001
10001
10001
10001
10001
10001
10001
10001
10001
10001
10001
10001
10001
10001
10001
10001
10001
10001
10001
10001
10001
10001
10001
10001
10001
10001
10001
10001
10001
10001
10001
11111
