NO ./textures/pepe/
SO ./textures/pepe/
WE ./textures/pepe/
EA ./textures/pepe/

C 0,0,0
F 0,0,0

111111111111111111111111
100000000000000000000001
100000000000000000000001
100000000000000000000001
100000000000000000000001
100000000000000000000001
10000000000E000000000001
100000000000000000000001
100000000000000000000001
100000000000000000000001
100000000000000000000001
100000000000000000000001
100000000000000000000001
111111111111111111111111
