NO ./textures/iench/
SO ./textures/iench/
WE ./textures/iench/
EA ./textures/iench/

C 0,0,0
F 0,0,0


111111111111111111111111
100000000000000000000001
10X000000000000000100001
100000000000000000110001
111111111000000001100001
100000000000000000000001
10000000000E000000100001
100000000000000000000001
100000001110000000100001
100110000000000000000001
100110000010000011100001
100000000000000000100001
100000000000000000000001
111111111111111111111111
