NO textures/wall_1.xpm
SO textures/wall_2.xpm
WE textures/wall_3.xpm
EA textures/wall_4.xpm

C 125,65,42
F 42,65,125
X textures/portal/

1111111111111111111111111111111111111111111
1000000001000000000000000000000001000000001
1000000001000000000000000000000001000000001
1000000001000000000000000000000001000000001
1000000001000000000000000000000001000000001
100000000200000000000S000000000002000000001
1000000001000000000000000000000001000000001
1000000001000000000000000000000001000000001
1000000001000000000000000000000001000000001
1000000001000000000000000000000001000000001
1000000001000000000000000000000001000000001
1000000001000000000000000000000001000000001
1111211111111111111112111111111111111121111
100000000000000000000X000000100000000000001
1000000000000000000000000000100000000000001
1000000000000000000000000000100000000000001
1000000001212100000000000000111112111111111
1000000002020200000000000000100000000000001
1000000001212100000000000000200000000000001
1000000002020200000000000000100000000000001
1000000001212100000000000000111111111111211
1000000000000000000000000000100000000000001
1000000000000000000000000000200000000000001
1000000000000000000000000000100000000000001
1111111111111111111111111111111111111111111
