NO textures/rgb2/
SO textures/rgb2/
WE textures/rgb2/
EA textures/rgb2/

C 0,0,0
F 0,0,0

111111111111111111111111111111111111111111111
100000000000000000000100000000000000000000001
100000000000000000000100000000000000000000001
100000000000000000000100000000000000000000001
100000000000000000000100000000000000000000001
100000000000000000000100000000000000000000001
100000000000000000000000000000000000000000001
100000000000000000000N00000000000000000000001
100000000000000000000000000000000000000000001
100000000000000000000100000000000000000000001
100000000000000000000100000000000000000000001
100000000000000000000100000000000000000000001
100000000000000000000100000000000000000000001
100000000000000000000100000000000000000000001
111111111111111111111111111111111111111111111
