    NO ./path_to_the_north_texture
SO ./path_to_the_south_texture   
WE ./path_to_the_west_texture
   EA ./path_to_the_east_texture      
               
   F 220,100,0    
 C  225,30,0

        111
       1101
      11001
     110011
    110011
   110011
   10011
1111011
1E0001
111111
