NO ./path
SO ./path
WE ./path
EA ./path
F 0,0,0
C 0,0,0

11111
1N 01
11111
