NO ./path
SO ./path
WE ./path
EA ./path
F 0,0,0
C 0,0,0

1111
1N0
1111
